먼 옛날에	A long, long time ago, / there was a tree...
한 그루의 나무가	A long, long time ago, / there was a tree...
그리고 그 나무에게는	And a young man / who loved the tree.
사랑하는 한 소년이	And a young man / who loved the tree.
그 소년은 매일 같이	Every single day / he came to the tree,
떨어지는 나뭇잎을	and collected
한잎 두잎	all falling leaves.
형숙아! 전화 끊자	Hyung-sook, / l have to hang up.
- 내가 다시 곧 전화줄게	- l'll call you back. / - Coming home...
진짜 오는 거지요?	this time for sure?
그럼...	Of course, / no matter what.
아니, 아빠한테 오랜만에	You must teach her / to take daddy's call
받기 싫어도	even if she doesn't want to.
아빠한테 교육을	Maybe daddy didn't / educate her properly.
교육...?	Educate?
내가 아니라 당신이겠지	lt's you, not me.
저는요	l gave her
좋은 교육만 시켰거든요?	the best education.
거 돈주고 학원에	Sending her / to private school
좋은 교육이야?	isn't good education.
팀장님! 팀장님!	Sir! lt's Tae-soon!
밝을 때 윤지 일굴 본 게	You rarely saw her
- 몇 번이나 된다고 큰소리야!	- when you had the chance. / - Okay, fine.
일단 끊어봐	l'll call you back later.
됐어! 이제 전화하지 마!	Don't bother.
사랑해	l love you.
헛소리하고 있네	Bullshit!
여보세요...	Tae-soon, it's me.
그래? 알았다	Okay, l got it.
태순아 고맙다	Thank you, / you're a good guy.
뭐야 이게?	Doesn't make sense.
얼마나 걸릴 것 같아?	How long will it take?
3일 정도...	About 3 days.
3일? 3일이 어디 있어?	3 day? Not good enough! / Move over.
아 나 참...	What the...
저기요	Excuse me.
요한 성당 가려면	Which way is / to Johan Cathedral?
아... 요한 성당이요?	Johan Cathedral?
이쪽으로 가다가...	Stay on this street...
저 태워주시면 안내해	l could guide you better / if you give me a ride.
잘 지내?	Been well?
다음 달이 애기 돌이다	My kid's first birthday / next month.
행복하냐?	Are you happy?
어, 넌?	Yeah, you?
곧 돌아간다	l'm leaving soon.
많이 보고 싶겠구나?	You must miss them.
유턴 한 번 할까	How about a u-turn?
경찰도 없는데	No police around.
- 지금?	- Now? / - Now.
야! 임마 너 어디가?	Hey, / where are you going?
죄송합니다	l'm sorry sir / l think l lost them.
이런 병신새끼!	lncompetent bastard.
고가타고 퇴근해	Keep driving and go home, / you idiot!
야! 전부 무장하고	Everyone get ready / and standby.
이새끼들 어디로	We don't know / wherethey'll end up
전부 차 안에서 대기하고 있어	so wait in the car. / Confirm last location.
- 뭐하나?	- Go on. / - Yes, sir.
다른 팀에 연락	&nbsp / Shouldn't we call / the other team?
죽 쒀서 개 줄래?	And give them / the credit?
우리끼리	We can take care / of it ourselves.
실례 좀 하겠습니다	Excuse me.
저기...	l need to...
화장실 좀	use the restroom.
춤 한 번 춰봐라	Dance for me.
춤춰봐	l said dance.
여기 아이들	Trendy dance that / the kids here like.
잘 춘다야	Very nice.
공부하라고지원해줬더니	Looks like / all our funding
춤이 늘었구먼 기래	went to dance classes.
니가 더 민첩하니까	Since you're more agile,
너는 나하고 올라간다	you come with me upstairs.
넌 아래에 있고	And you stay below.
야! 뭐야?	What are you?
- 택배야?	- Delivery man? / - Yeah.
야 경남아	Kyung-nam, / you look plain
평범하게 보인다	even without the disguise.
왜 왜?	You don't drive well,
뒤에 타	get in the backseat.
야! 구의동 숭민아파트!	lt's Gui Soong-min apartment!
- 출발해!	Let's go!
잠깐만 그 아파트에	Wait, who lives there?
김성학이	Kim Sung-hak / Kim Jung-il's second cousin.
어이, 씨발 좆 됐다	Fuck me.
갖고 있어라	Keep this.
끝나면 1층에서	After it's done, we'll part / on the first floor.
그리고 터미널에서	Rendezvous / at the terminal
같이 올라간다	and go back together.
예!	Okay.
벌써부터	l can already feel / the bloodbath.
액센트 액센트	Accent in front, / out of the way!
8487 액센트	Accent in front, / out of the way!
8487 액센트	Accent in front, / out of the way!
차장님...	lt's the director.
예... 이한규입니다	Lee Han-kyu here.
야! 이한규!	What do you think / you're doing?!
예, 지금	'Shadow' is on the move.
- 이번에 놓치면...	- lf we loose him... / - Shitbag!
그럼 보고를	Why didn't you / report this!
갑자기 발생한 상황이라	lt happened too quickly / so l'll report afterward
내가 니네 잡았어	l got you.
잡으면 될 거 아냐!	That's all l need to do.
누구세요?	Who is it?
예, 평화의 교회에서	Morning, / l'm from the church.
김성학씨 계십니까?	ls Mr. Kim Sung-hak home?
요 앞에 가게	He went to / the corner store.
누구? 장모?	You are... mother-in-law?
네... 그 런데요?	Yes, that's right.
천천히 가 넘어져	Slow down, you'll trip.
어! 이놈 봐라	l'm gonna get you!
뭐	What?
김성학만 처리해도	l don't think / this was necessary...
너 내 아들새끼	l'll be frank since / you're like my son.
남조선에 낭만적인 놈들은	Romantic Southerners / are whores.
머저리 같이	Every one of them.
그거 보라우	Look at them.
연민 때문에 북에서 내려온	She married a defector / out of compassion and was killed
그렇게 됐잖네?	because of it.
자 들어가자	Let's go in
어이 다왔다, 태순아	We're here. / Where are you, Tae-soon?
요 쌍놈의 쥐새끼래	You backstabbing rat, / take a good look.
내 눈 똑바로	You backstabbing rat, / take a good look.
닌민들의 축복을	You leached off our / nation's generosities
장군님을 모략하는	but publish a book / that taunt our leader?
밤마다 니 모가지	l dreamt of killing you / every night.
- 1103호 랍니다	- lt's apartment #1103. / - #1103...
야 1조 먼저 들어가	You go first that way.
빨리 짐 빼!	Clear the way!
- 몇층이야?	- What's the floor? / - 11th floor!
- 동지...	- Comrade... / - Son of a bitch!
- 그래도 아이는...	- He's just a child... / - Remember.
강성대국의 아들 중에	Our great nation / cannot have
나약한 놈은	a single fragile son.
이 개새끼래	How dare you / betray me?!
아닙니다	lt wasn't me. / l don't know anything.
꼼짝마!	Freeze!
저... 전 그냥	l just live next door.
아이가 혼자	The boy was crying.
- 민철이 올라가봐!	- Min-chul, head up. / - Yes, sir.
- 밑에 이상 없습니다	- No problem downstairs. / - Get up.
손들어 손들어	Hands up, asshole!
1조, 1조 목표물 확인	Target confirmed.
확인해봐	Check him.
괜찮아? 어? 정신차려	Are you okay? / Can you hear me?
괜찮습니다	He's okay.
민철이냐?	ls that you Min-chul?
민철아!!	Min-chul!
민철아!	Min-chul!
이런 개새끼	Son of a bitch!
고경남 대답해 1조	What's going on? / Agent Ko!
야, 야!	Hey!
1조 야 차 저쪽으로	Get the car around / that side!
- 자, 뒤로 물러나세요, 뒤로	- Back off! / - Ko Kyung-nam!
- 야 고경남	- Agent Ko! / - Sir...
- 그러니깐 일단 후퇴를 해	- Pull back right away! / - Sir, one went down!
수영아 엄마는?	Si-kyung! / Where's your mom?
- 전부 사진 찍어	- Take pictures of everything! / - Yes, sir.
경 남아!	Ko, give me the physical / description!
젠장 어떻게 된거야	What's going on?
야 저기도 나오잖아 저기	Over there, more people / coming out of there.
예	Yes, sir!
후퇴를 하란 말이야	l said pull back!
저쪽 출구 봉쇄해	Seal that exit!
예, 비켜, 비켜	Yes, sir. Out of the way!
키 185에 검은 양복	6' tall wearing black suit
비켜	Out of the way!
- 이거 뭐야 이거	- What the hell! / - Get in!
야, 너 괜찮아?	Are you okay?
- 예 괜찮습니다 타세요	- l'm fine, get in! / - Hurry.
- 김성학이는 어떻게 됐어?	- What about agent Kim? / - He's dead.
아이 씨	Shit!
야야야 그냥가	Watch out!
비켜 비켜	Move! Move!
야 야	Step on the brake!
에이 씨발, 운전 진짜	Shit!
괜찮으세요?	Are you okay?
빨리가 빨리가	Go! Keep driving!
예, 알겠습니다	Yes, sir!
야, 사람 조심해 사람	Watch out for the people!
야 빨리 아직	Move! Out of the way!
빨리 빨리 리어카	Move! Out of the way!
조심해	Be careful.
잡았다	l got you now.
- 뭐해 밟아	- Floor it! / - Goddammit!
뭐야 씨 뭐야 어?	What the hell?
지원 요청 왜 안했어?	Why didn't you / request backup?!
왜 안했냐고?	Why?!
지금 보고 체계로는	We can't keep up
쟤네들 움직이는 속도를	with their pace through / normal chain of commands.
선조치 후...	We must act first...
각오하고 있어	You be ready.
여보세요?	Hello?
내가 이쪽 책임자다	l'm the agent in charge.
우린 너하고 손태순이를	We're not / after you or Tae-soon.
북에서 내려온 그 놈	Our target is
국제적으로	a North Korean assassin,
당 서열 43위	a high ranking officer.
이름은 여러 개지만	He goes by many names
통상 그림자라고 불리는 놈	but commonly known / as Shadow.
우린 그 놈을	That's who we want.
니가 도와주면	With your help, / we can get him.
약속하마 그 놈만 잡으면	l promise you / we'll help both of you
원하는대로 해준다	if we get him.
너 김정일 정치	Tae-soon said / you graduated
똑똑한 놈이라고	from Kim Jung-il's / military school.
그 외에는 난 너에 대해서	Aside from that,l don't know / anything about you.
얼굴도 몰라	Not even your face.
지금 곤란하면 나중에	We can talk later / if you're in a situation.
내 전화 번호	l'll give you my number
외우고 있어라	Memorize it / 011 865 92...
분단 55년 만에	Two leaders / got together...
님북정상이 만나는	for the first time / in 55 years.
잠깐만요	Hold on.
저 그 동안 문책에 감봉에	l suffered through / salary reduction
징계 다 맞았습니다	and disciplinary actions.
그래놓고 짜른다고요?	Now you want my throat?
인원 감축안이	Getting honorable / discharge
명퇴 신청 받는거는	before official / staff reduction
그 동안 여러분들이	is a generous way for us / to thank you for the work.
또 대공수사 요원들	Having too many agents / on the field
지금 같은 때에	is too much burden / for the agency.
부담이라뇨	Burden?
아니 우리가 돈 받고	Were we getting paid / to fool around?
국민들 편하게	Our job is to catch / spies so
우리가 간첩 잡는거	our people can / sleep soundly.
시대가 바뀌었어	Times are changing.
남북정상이 만나서	Hostility is not / the answer anymore.
저쪽 얘들도 지금 공작원들	Their field operations are / coming to a halt.
예 좋습니다 좋아요	Fine. But at least / let us finish this
이번 수사는	before cutting us off.
그림자 그 놈 잡기전엔	l won't leave before / catching Shadow first.
이한규 일단	Agent Lee / Stay out of this.
어차피 사고책임자	You've caused more / than enough problems.
예 저도 뭐 피눈물 납니다	l lost my teammates / who were like my family.
하지만 진짜 가족은	But l still have to / feed my real family.
이혼했잖아	You're divorced.
양육비는 내가 냅니 다	But l'm still / paying alimony.
별 얘기를 다하네	What am l saying?
아니 그래도 한창 나이에	l can't just step down / during my prime.
그러니까 니가	This is why you / don't get anywhere.
간첩 잡는 일을 한낱	You don't catch spies / to make money.
너 같은 놈들 때문에	You're the reason
우리가 보수 꼴통이라는	why our agency is / getting the bad rep.
들어오기 전부터	Looks like this was decided / even before this meeting.
사고를 쳐서 그런거야	ls it because / of field problems?
뭐 이혼 때문이야	Or getting divorced?
짜르려면 씨발 한가지로	Just stick to one reason / for termination.
뭐 이 새끼야!	What did you say?
김성학이 때 왜 당신한테	Do you know why l didn't / bother reporting?
말하면 뭐해...	What's the point?
씨발 좆도 우유부단 하고 윗대가리	You're goddamn / pushover and a tool.
이 새끼가!	You bastard!
나 한 놈한테	Once is plenty enough.
이 새끼가	Where do you think you are?!
참으세요 팀장님 팀장님	Calm down, Agent Lee.
놔! 이새끼야	Let go of me!
시대고 뭐고	Changing times? Fuck that!
나 빨갱이 잡는	l'm a federal agent / who catch commies!
야! 야 하지 마	Hey, don't do it!
- 달라매	- You wanted it. / - lt won't be good.
- 달라고 했잖아	- You were gonna do it. / - lt's dirty.
아가씨, 여기 너무	Hey miss / your food's great.
사진을 좀 찍어서 인터넷	Could l take some photos / and post it online?
인터넷 어디요?	Online where?
인터넷 동호회요	An online club
맛 집 찾아다니는 그런거	for finding good restaurants.
뭐... 그러세요	Sure.
얘! 이리와서 이것 좀	Come here / and give me a hand.
빨리 빨리 좀 담아라	Quickly, customers / are waiting.
여기 있습니다	Here it is.
여기보시면은 여기	There're address, phone number / and even directions.
찾아가시는 길까지	There're address, phone number / and even directions.
아 이백만원	For extra $2,000,
직접 여기로 모셔다	we can bring her / back for you.
아니요...	No, l'll go myself.
예	Okay.
예 예 고맙습니다	Thank you.
이 두분	Looks like your life / is hard enough.
며느님 돌아오시면 세분	l hope that / you'll be happier
알콩달콩 재미나게	when your wife comes back.
저 그럼 이만	l'll be on my way then.
어, 윤지야 왜?	Hey, Yoon-ji.
아빠? 아빠 지금 돈벌고 있지	Daddy? / l'm working right now.
어? 알버트가 엄마만 좋아해?	Don't just like mommy. / You have to be good.
그리고 윤지야 아빠한테	Yoon-ji, / don't call me too much.
엄마가 곤란해지잖아	Mommy won't like it.
어... 엄마 없어?	Mommy's not there?
그래, 아빠는 잘있으니까	Don't worry about me, okay?
여보세요?	Hello?
야 삐뚤어졌잖아, 임마	Hey! lt's slanted!
놀러왔냐?	Quit fooling around!
너 백오십, 너 백오십...	l'm paying each / of you $1,500.
니들이 직원이야	You guys / are highway robbers!
아, 계장님	Chief!
아, 이거	Congratulations / on your promotion!
비도 오는데	You didn't need to / come on a rainy day.
걔네들... 처음에는	These guys were brokering / international marriages.
뭐 베트남여자	Vietnamese,
필리핀 캄보디아 뭐 동남아	Filipino, Cambodian and / other Asian countries.
암튼 뭐 걔들 데리고 와서	They bring the girls over, / marry them
처음에 결혼시키고	They bring the girls over, / marry them
그리고 나서 인제 뭐	then convince them
살살 꼬드기는거죠	that there're better men.
암튼 농촌총각 두번 죽이는	They're ripping off / poor farmers.
인상 더럽네...	Look at this appalling face.
아! 이 놈이 두목이에요!	This is the boss.
라이따이한인데	He's half Korean / but worse than the Vietnamese.
그래도 얘네들은...	But this is / an organization.
아이고 사장님네도 뭐	l know you're the best / man for this.
암튼 골칫거린가 봐요	They must be stirring / quite a bit.
뭐 경찰청에서도 현상금을	The department put high / reward on them.
6천이던가?	About $60,000.
6천?	Sixty?
예, 걔들 주로	l hear they go to / the factory
공장에 나타난다는데	where many / Vietnamese work.
참 그 두목이란 놈	The boss goes / nuts over soccer.
야 야 저쪽으로 가 가지고	Go over there. / Sweep thoroughly
왜 왜 꼴대 앞에서	Playing basketball / in a soccer field, morons!
야! 이 새끼들아	Hey! / What are you doing?
- 축구 보러왔어?	- You're not here to watch soccer! / - Okay.
- 재환이	- Jae-hwan. / - Yes, sir.
뒤에 양키즈 모자	Do you see that guy / in Yankees hat?
흰옷 입고 뚱뚱한 놈	Fat guy in white suit.
예	Yes.
여기서 잘	l can't verify / from my position,
비슷하지 않아?	but what do you think?
가까이서 보고 올게요	l'll check up close.
야야야야	Hey, hey!
야 아직이야 임마	Hey, hey! Not yet!
아 저새끼 저거	That crazy idiot!
맞는 거 같은데요?	l think it's him. / Should l grab him?
야 이새끼야 너 죽고 싶어?	Do you want to get killed? / Get out of there!
네	Okay.
야 재환이 재환이	Jae-hwan! Jae-hwan!
야 성철아	Sang-chul, / l can't spot Jae-hwan.
재... 재환이요?	Jae-hwan?
양키즈 모자	Did you see a guy / in Yankees hat?
양키 양	A what? Yangi?
야야야 재환이부터	Find Jae-hwan first, / quick!
너 왜 대답을 안하냐고	Why aren't you / answering me!
야 너 거기서 뭐하냐?	What are you doing here? / Boss is looking for you.
그러고 무전기	And why's your / radio set off?
무전기 쳤으면...	You can't...
사장님	Boss, we're / fucked here.
아 알았다!	All right, l'll be there.
야! 임마!	Hey!
이리들 와라	Do your worst, come at me.
그렇지 오케이	That's it.
야 내가 이 새끼들	l'll get / the minions,
너넨 저 뒤에서 오는	grab that bastard / over there.
알았지? 자 시작해	Got it? Now!
야! 어디가 임마	Hey, where are you going?!
아저씨	Hey, where are you going?!
아이 나 씨	Shit!
야 잠깐 잠깐 잠깐	Hey, hey, stop, stop!
괜찮으세요?	Are you okay?
예 여기	Yeah. / Are you a worker here?
한국 분이시네	You're a Korean.
경찰이신가 보죠?	Are you a cop?
아뇨 저기 저기 그냥	No, l run a small...
조그만 이 지명수배 된	They're wanted men.
현상금 좀 타려다가	l was after / the reward money...
가스총으로 참	with a gas gun.
근데, 저기 이름이...	Your name is?
이름은 왜요?	What for?
아니 너무 고마워가지고...	Just want to thank you.
박기준씨	Ki-joon!
병원 가보세요	Go treat your wounds.
저기요!	Hey!
왜 그러시죠?	What is it?
아 예, 거 뭐 이거 초면에	lt's weird to ask you / this like this,
혹시 저하고 같이	but would you consider / working for me?
무슨 일이요?	What type of work?
사람 찾는 일입니다	Finding people.
공인된 업체고	lt's a real enterprise / and well commended.
아까 보니까 찾기만	Looked like finding wasn't / the only thing.
아 저런 일은 십 년에	Ah, that happens once every / 10 years if l'm lucky.
경찰 좀	l was helping / out local cops.
저 직장	l'm find where l am.
아예 알죠, 근데 제가	Of course. / But l noticed that
이 시점에서 제가	you may be / an asset to me.
그 아까, 성함이...?	Your name was...?
박기준입니다	Park Ki-joon.
박기준씨...	Park Ki-joon. / Your fighting skills...
그 운동신경도 좋으시고	l mean, physical condition...
그리고 아까 베트남어도	and you speak / Vietnamese well.
베트남어는	Where did you / learn to speak?
저희 직원들 대부분이	Most of our workers are / Vietnamese, so...
아, 이 정말 모든 것이	lt's perfect. / l'm in the business of
도망간 베트남 처녀	finding / Vietnamese women.
거 뵌지	We haven't known each / other long
정말 이게	but why don't you / come work for me?
저 지금 하는 일	l like / my current work.
아 예	Of course.
제가 이제	lt's time / for me to go.
그럼 저 언제	How about you call me.
박기준 좋아하네...	Park Ki-joon / my ass.
송지원이!	l got you Ji-won.
사장님 사장님	Boss, are you okay?
키	Key.
예	Here.
잘 살아라	Live well, / stop wasting your life.
뭐야 진짜 가는데	He's really leaving.
사장님	Boss!
- 여보세요	- Hello? / - lt's me.
- 누구세요?	- Who? / - lt's your daddy, idiot!
누구? 팀장님!	Who? Agent Lee?
- 경 남아	- Kyung-nam. / - Yes, sir!
- 나 로또 맞았다	- l just hit the jackpot. / - Huh?
누구세요?	Who is it?
족발이요	Pork feet!
족발... .?	Pork?
팀장님!	Sir!
너 아직도	You still go / around like this?
정말 입니까?	ls that true?
아 그렇다니까!	Like l said. / He's there as the manager.
지원이가 팀장님	Ji-won didn't / recognize your face?
모르지!	Of course not, / he has never seen me.
팀장님은	But you recognized him?
나야 대번에 알아봤지!	l knew right away.
팀장님 엄청 놀라셨겠네!	Man, weren't you surprised?
아니 눈치 못 챘을요?	Did he not clue in?
당연히 모르는 척 해야지	l pretended / to be oblivious.
거기서 ' 어! 너! '	lf l acted like / l knew him,
다 끝나버리지!	it would've been / game over.
너 내가 한 연기	You know l have a knack / for acting.
아무튼 감사합니다	ln any case, thank you.
안 그래도 실적 땜에	My arrest rate / isn't great lately.
- 경남아!	- Kyung-nam. / - Yeah?
송지원이 너한테 넘길려고	l didn't call you / to hand him over.
신고 안하실 거에요?	Aren't you going to / report him in?
이건 내가 주도하는 거야	l'm leading this.
너는 나를 도와주는 거고	You're just / supporting me.
무슨 말인지 알겠어?	Do you get it?
모르겠는데요	No, l don't.
국정원에는	Keep it away from / the agency, you idiot!
네...	Okay...
요즘 간첩	What's the reward / for spies nowadays?
1억이요...	$100,000
간첩단은?	And spy ring?
네?	Huh?
얼굴이 좀 상했구나	You don't look well.
며칠 전에 국정원 사람하고	l met an NlS agent / a few days ago by chance.
6년 전에	Lee Han-kyu,
태순이하고 절 찾던	who looked for Tae-soon / and me 6 years ago.
이한규?	Lee Han-kyu?
네 근데...	Yes. He asked me to work for him
같이 일하자고 하더군요	as if he didn't recognize me.
무슨 흥신소 같은데?	Looks like / a private agency.
언뜻 보면 그런데...	On the surface.
국정원 애들 국정원이라고	l'm sure / it's just his cover.
- 그래서?	- So? / - l don't know.
언더커버 리포트라도	Maybe submit / an undercover report.
지원아	Ji-won.
차라리	How about
- 자수를 하는 건 어떠냐?	- surrendering? / - You made me
교수님이 제게	into what l am / in military school.
근데, 이제 조국을	And now you're asking me / to betray my country?
교수님 처럼요?	Like you?
입 조심해!	Watch your mouth!
그럼 도대체 뭘	So what are you / going to do?
6년간	l've been on the / run for 6 years.
이젠 무슨 일이든	lt's time / to end this.
다시 오지 않겠습니다	l won't visit you / again.
팀장님 그냥 포섭 들어가는 게	Won't it be better / to switch him over?.
비공식 루트로...	ln an unofficial / route.
손태순이처럼?	Like Tae-soon?
그러고 요새 공작금 끊겨서	The spies are nuts / over working
취입난에 알바자리들	for us after their / funding ran dry.
벌써, 같이 일하자고	l already asked him / to work with me.
예? 그랬더니요?	Yeah? / What did he say?
지가 하는 일이 맘에 든대	But he likes his work.
- 나참 뭐, 그런 놈이	- What... / - Anyway,
퇴근하면	Come relief me when you're done.
- 예 여보세요	- Hello? / - Sir, it's me.
야 어제 왜 안왔어?	Why didn't you show up / yesterday?
- 차장님! 차장님!	- The director's here. / - Hey!
- 잠깐만요	- l'll call you back. / - You're the one who called.
야, 차장 갔냐?	ls he gone?
저, 박기준이라고	lt's Park Ki-joon, / we met a couple of days ago.
네? 누구? 박기준?	Who? Park Ki-joon?
박기준! 박기준씨!	Ah, Mr. Park! / Park Ki-joon!
아 괜찮아요, 괜찮지!	Yes, sure. / How can l help you?
아... 예	Ah, l see.
- 식사는?	- Had lunch yet? / - Not yet.
햄버거 하나 먹을까?	How about a burger?
저 그런 거 잘 안 먹습니다	l don't like burgers.
아무튼, 잘 생각했어!	Anyway, you chose wisely.
요즘 같은 때는 자기	We have to push our / strongest traits.
아 대기업 다니는 사람도	Even the office workers
나이 사십이면 나갈	look for a way / out in their 40s.
저 아직	l haven't / decided yet.
조건을 좀 듣고...	l wanted to hear / the conditions.
아 예... 돈이	l see. You must need / a lot of money.
아파트 중도금 때문에...	Downpayment / for an apartment.
아파트 중도금...	Apartment? How big?
31평이요	About 100m
오, 자수 성가했네	A self-made man, / so young too.
아 그 아파트라...	Apartment...
이, 이게 우리 나라는	That's our / nation's problem.
아파트 때문에 떼부자 되고	People become rich over it,
아파트 때문에	families get broken up,
우리 같이 아파트 때문에	but it also unites / others, like us.
얼마 주실 겁니까?	How much will you pay me?
전에 직원이 둘이 있었는데	l paid my old employees / $2,000 total...
아, 근데	But l can't give you that,
뭐 기준씨야	it's hardly enough for you.
이백오십...?	$2,500?
보다 많은 칠십?	Add another 200?
삼백!	$3,000! Housing included!
죄송합니다만...	l'm sorry...
그 정도는	l get that / with my current job.
아니!	Of course,
뭐 얘기를	but l'm not done yet.
인센티브 얘기 안 했잖아!	There's also incentives.
그게 얼만데요?	How much will that be?
인센티브는 보통	Usually incentives / are...10%.
30프로!	30%...No higher.
언제부터 일하죠?	When do l start?
지금부터	Right now.
아이, 올 때마다 뭐 할라꼬	You don't need to / bring gifts every time.
아 행님도 마...	Bro, it's Thanksgiving.
참내 추석은	Thanksgiving is in 4 months.
점마는 뭐꼬?	Who's he?
어 기준씨 인사드리지	Ki-joon, greet him.
우리 새 직원입니다	He's my new employee.
그래? 아니	Yeah?
고향이... 어디신가?	Where are you from?
아 형님은 뭐 그런걸	Why are yo u asking / stuff like that?
전라도 해남입니다	lt's Haenam, sir.
그래? 해남 어디?	Really? Where in Haenam?
왜요?	Why? Don't l look country?
아니	lt's not that, / you don't have a dialect.
아니, 둘이	Don't you know / each other?
아, 아닙니다 아 형님	No, it's not that.
행님 제가 뭐	Bro, / l have something to ask.
요 뭐 함 보이소	Take a look.
아니 사장님 절 따라	Boss, why / are you following me?
그러니 까...	Right, right.
저기요 좀 서봐요 예?	Hey, please stop.
그래봤자 멀리 못가요!	You won't go far like this.
뭘 그렇게 힘들게 뛰고 그래	You're gonna / tire yourself out.
싫어요 싫어요	No! No!
이렇게 하면	One case completed.
꼭 이렇게까지	ls that absolutely / necessary?
- 뭘?	- What? / - The cuffs.
아 아줌마 미안해요	Ma'am, l'm sorry.
빨리 댁에 가서	l'll uncuff you at home.
풀어드리죠 무슨	Please uncuff her, / this is torture.
한번 잡은 사람 도망가면	lf she escapes / after we get her,
그 다음엔 대책이 없어	she's gone for good.
차가 달리고 있는데	How can she escape / while the car's running?
이봐요 기준씨	Listen, Ki-joon.
아니 우리 일이	Do you have to / make it unpleasant
꼭 그렇게 사람 불편하게	on our first day / together?
아니 내가 저 아줌마를	Did l beat her?
때리기를 했어	Or curse at her?
것보다 나을게	ls that any better / than either?
이봐요 나도 기준씨처럼	Listen to me. l have pride
자부심을 갖고	in my work just like you do.
왜 나는 대한민국 가정을	Why? l keep this nation's / families together.
우리가 경찰도 아니고	We're not cops and
무슨 죄를 지은 것도 아닌데	they haven't committed / any crimes.
인간적으로 대해 줬으면	Please treat them / like humans.
기준씨 우리 일에도	Ki-joon. There's a / dark side to our work.
음지에서 일하고	What we do will have / positive effects...
저 새끼가	Bastard, / an adult is talking.
어이! 차 움직일 때	You could do that / while we're moving!
에이씨	Shit!
어 들어와	Come on in.
여기서 나랑	You can stay here with me.
뭐 말이 사무실이지	lt's my office but
요즘 오피스텔	comfortable enough to stay.
내 집이라고 생각하고	Make yourself at home.
이거 혼자 살다 보니깐	Side effect of living alone.
참 내가 위층 쓸테니까	l'll use / the upstairs and
자기는 여기 아래층 써...	you can use / this space here.
위층에는 올라오지 말고!	Please don't come up.
그냥 떨어진 거야	lt just fell.
부엌 칼이야! 부엌 칼!	lt's a kitchen knife!
내가 미쳤지...	l must be nuts. / All this for money.
아직도 인 들어 왔어요?	Still not back?
한숨도 못 잤다	l haven't slept a wink.
근데 혹시... 지원이가	What if he figures it out / and brings Shadow?
그림자를 싹 데리고	What if he figures it out / and brings Shadow?
나를 어떻게 알고	How could he know me?
야야 쓸데없는 소리	Cut the crap, / l'm hanging up.
어디 갔다 와?	Where have you been?
들어와!	Come in. / You have a guest too.
이씨 빨갱이 새끼들	Where is that commie!
어디 갔어? 수갑	Where are the cuffs?
어제 송지원이...	Yesterday, Ji-won...
어디 갔다와?	Where were you?
어 이거?	This?
저기, 테스트	l was just testing it.
요즘 이게	Doesn't work well.
어? 기준씨...	Ki-joon,
어제 열쇠 좀!	the key please.
어 어 그냥 던져	Just throw it.
오늘은 또 무슨 일하죠?	What do we do today?
예, 조선생님!	Yes, Mr. Jo.
제가 찾으면요	We'll call you / when we find her.
전화 바로 드리겠습니다, 예 예	We'll call you / when we find her.
잠을 잘 못 주무셨나 봐요?	Haven't slept well?
제가 운전 할까요?	Should l drive?
이 차는 내가 운전을 해	No, only l drive this car.
어휴 큰일 날 뻔 했네	That could've been nasty.
그니깐 우리가 여기잖아! 그 지	We're here.
기준씨가 이 뒤쪽으로	You start from this side.
난 이렇게 뒤로	And l'll cover this area.
그렇게 무작정	Rather than / an aimless approach,
사장님이 이쪽 대각선	you go diagonally like this.
제가 이쪽 여기서부터	And l take the opposite route.
이쪽 대각선 방향으로 가로	And l take the opposite route.
그렇게도 안 되면	lf not we flip / 45 degrees and try again.
한번 더 하면	We'll get her for sure.
나도 아는데	l know that method.
어디서 배운 거야?	Where did you learn it?
인터넷이요	Online.
다 지난 옛날방법을...	lt's an old trick.
어디 한번 해봐	All right, / let's give it a try.
그래	Yeah.
뭐 혹시... 건진 거라도	Any progress yet?
건지긴 새꺄, 월급을	Progress? / l might be paying him $3,000.
예 300이요?	$3,000?!
그것도 기본급만	That's just base pay.
그래도 안 하겠다는 걸	l had to lure him / with 30% incentive too...
얼떨결에 인센티브를	l had to lure him / with 30% incentive too...
참 뭔 빨갱이가	What kind of communist / is so fixated on money?
아 어따 쓴데요 돈을?	Where is he spending / the money?
뭐 아파트 중도금	Says it's for / an apartment, shit.
사장도 월세	All the while his boss is renting.
또 지 혼자	He pretends to be noble and
내가 하는 일이	tells me l'm being inhumane.
뭘, 물어보면	He doesn't answer / anything properly.
씨발... 아주	He's practically / the boss around here!
빨리 뭔 수를	l gotta find a way soon.
월급이 현상금 보다	His salary's going / to be bigger than...
찾았어?	Find her?
저 빨갱이 새끼	Goddamn commie.
그래서 제가	That's why
마누라를	l have to find my wife.
혹시 모르시겠습니까?	Have you seen her?
우리 그런 거 몰라...	We don't know.
아 뭐해 하지 않고	Come on, play!
나? 아고 뭘	Me? lt's my turn?
아이고 계속 치세요	This granny's hand / is worthless.
이쪽 할머니 똥광 들었네	This granny's hand / is worthless.
할머니 똥쌍피 내려놓고	You could put your / hand down and call it.
원래 돈 오가면은	No mercy when / it comes to gambling.
찾았습니다	l found her.
또 한명은 누구야?	Who's the other one?
둘이 같이 있던데요	They were together.
동네에서	They must've escaped / with each other.
어떻게 데리고 왔는데?	How did you bring them?
설득했죠	l convinced them...
인간적으로	Humanely.
그 인간적인 건 알겠는데...	l got the humane part,
찾기는 어떻게	but how did you / find them so fast?
빨리 찾으면 안 됩니까?	ls that a problem?
아니지... 아니지	No.
사례를 어떻게	l don't know / how to thank you...
원래는 사람 찾는데, 이백	Normally $2,000 for finding,
데려다 주는데 이백!	bringing back $2,000 / for a total of $4,000
부인이 직접오신 거니깐	She wanted to come on / her own, so it's okay.
그래도 우리가 아니면은...	But if it wasn't for us...
어떻게든 답례는 해야죠	l must repay you, humanely.
그렇죠, 인간적으로!	Of course, humanely.
참 인간적이다	Very humane, indeed.
에이씨!	What the hell?!
잡아 잡아	Get it! Quickly!
잡았다 잡았다	l got it, got it!
나이스! 나이스!	Nice! Nice!
그거 가져갈려면	Cuff it if we're / bringing it home.
아이씨 진짜 아이	Jesus Christ!
저리 치워! 좀	Move that somewhere!
음식인데요, 뭐?	lt's just food.
거 아침부터...	Let's not start already.
너 혼자 먹어!	l don't want it, you eat it.
맛있다	Delicious.
토종 씨암탉	Genuine chicken broth.
누가 해준	Been a while since / someone cooked for me.
사모님하고 따님은 어디 두고	What happened / to your wife and daughter?
내가 전에 같이 살 때	l wasn't much / of a husband to her.
이 일이 좀 바뻐	This work can be demanding.
뭐 지금은 애 데리고	She remarried a British man
영국 사람이랑 재혼했지!	and moved to / England.
그 친구 이름이 알버튼데	His name is Albert and
내 딸 이름을	renamed my daughter Amy.
애 이름을 에이미가 뭐야?	What kind of stupid name / is Amy?
안보고 싶으세요?	Don't you want to see her?
거기 가고 나서부터	l haven't seen her
한 번도 못 봤네...	once after they left.
아무튼 나중에	l want to buy her a home
내가 집 한 채	when she gets married.
그러실 수 있을 거예요	You will be able to.
그럼... 그럴 거야	Of course, that's what l'll do.
너는 장가가면	Be good to your wife / when you get married.
오케이! 하루 더!	Okay! One more day!
어디 가세요?	Are you going out?
너도 나가서	Go out and meet / some people too.
젊은 사람이 집에 있는 걸	You're too young / to be cooked up in here.
누굴 만나요?	Meet who?
친구나 여자 없어?	A friend or a girlfriend?
서울엔 친구 없어요	No friends in Seoul.
여자는 관심 없고요!	And not interested / in girls.
그럼 어디 가서	Then go have fun / somewhere.
아까운 휴가를	Don't waste your vacation / like this.
그냥 집에서	l'll just watch some TV.
여보세요	Hello?
어 윤지야	Hi, Yoon-ji.
아빠 일하지...	Daddy's working.
윤지는 뭐했어?	What are you doing?
응? 정말?	ls that so?
알버트가 피아노	Albert's teaching you piano?
좋았겠네...	Must've been nice...
이제 새 아빠 좋아?	Do you like your new dad?
아빠가 더 좋아?	Like me better?
생일 선물? 뭐?	Birthday present?
디카?	Digital camera?
그건 그쪽에서	You can buy that there.
아빠가 돈 더 보낼테니까	l'll send money so / ask your mom for it.
그래 아빠 바빠서	Daddy has to go, honey.
태순아!	Tae-soon! Over here!
매번 고맙습니다	Thank you, as always.
그래 잘 좀 살자!	Let's all live well.
재미있게 사는구나	Quite cozy.
겨우 이따리로 살려고!	You sold your country
조국과 동무까지	and comrades so you can / live like this?!
간나 새끼 때문에	l'm treated like a traitor and
내까지 변절자 취급받고	l'm treated like a traitor and
북으로도 돌아 못가고!	l can't go back / because of you!
니새끼 때문에...	You did this to me!
무슨 말이라도	Say something!
살고 싶다	l want to live.
나 살고 싶다	l want to live!
씨베	Shit...
미안하다	l'm sorry.
가족들은?	What about the family?
며칠 처가집에 갔어	Went to the in-laws / for a few days.
근데, 내 여기 있는 건	How did you know / l was here?
낮에 국정원 사람 만났지?	Didn't you meet / an NlS agent earlier?
아냐! 그건	No!
나 이제	l'm not part / of that anymore.
그리고, 이한규 그 사람	And Lee is / not an agent anymore.
그 사람도 더이상	And Lee is / not an agent anymore.
그게 무슨 말이야?	What are you talking about?
그때, 작전실패하고	He took responsibilities / for that
구조 조정돼서	botched operation / and was fired.
더이상 그쪽 일 안해!	He doesn't work / for them anymore.
차장님이 팀장님	The director was asking / about you.
내 안부? 내 안부를 왜?	Me? What for?
참 나 세상 별일 다 있네	ls hell freezing over?
그 양반도 참 생각보다	He's up there for a long time.
어렵게 구했어요	lt was hard getting it.
아직 출시도 안 된거...	lt's not even released yet.
야 요즘 핸드폰 위치	lt's no biggie / triangulating a cell,
GPS 가지고	don't make a fuss over / a GPS tracker.
핸드폰 안테나는	This will work / even when cells don't.
싫으면 가져가고요	l'll take it back / if you don't like it.
가져가기는! 위...	Forget that. / Give me the receiver.
이거 아무도 모르지?	No one knows, right?
음, 오케이	Yeah, okay.
희소식 하나	There's a new development.
또 뭐 빅뉴스?	A big news?
위쪽 애들	l think something's up / in the North.
그래? 무슨 일인데?	Yeah? / What's going on?
이따가 뉴스 보세요	Go watch the news.
이제 오세요?	You're back?
하루종일 티비	TV all day? Always / the same music show.
뭐 가수 될 거야?	You trying to be a singer?
방금 들어온 소식입니다	There is a breaking news.
북한이 조금 전	North Korea will / carry out
수일 내로 핵실험을	a nuclear missile test / within a few days.
자위를 위해	For our proud nation,
선의에는 선의로	we have developed / nuclear weapon.
저 새끼	Why are those fuckers / acting up again?
북한은 그 동안	lt's been known / that North Korea was
여러차례 시사해 왔지만	developing nuclear arsenal.
외무성 대변인이 공식	But this is the first official proof / of its existence.
공식 천명하기는	But this is the first official proof / of its existence.
북핵 문제를 둘러싼	This development / will renew
더 높아질 것으로 보입니다	the tension / between two nations.
하지만 북한은	They claim that / the weapons will not be used
자위적 핵 억제력으로	They claim that / the weapons will not be used
미국이 대북 적대정책을	unless provoked / by the US...
어이 깜짝이야 씨	What the hell!
야! 웬일로 차려입고...	What's with the suit?
어디 좋은데 가냐?	Going somewhere nice? / Looks great.
모임이 좀 있어서요?	There's a soiree.
무슨 모임?	A soiree?
동창모임이요	lt's reunion.
초등학교 때	l wanted to meet / some old friends.
초등학교?	What kind of school?
초등학교요	Primary.
아... 그 초등...	Ah, elementary school. / Really old friends then.
난 또... 다녀와	Go on.
좀 늦을 겁니다	l might be late.
어... 잘 갔다와	Have fun and
술 너무 많이	don't drink too much.
어 경남아!	Kyung-nam!
- 드디어, 입질 왔다!	- lt's time! / - Sir?.
지원이가 초등학교	He's going to / a school reunion.
그래서요?	So?
그래서요라니 이 밥통아!	Think, you moron!
북에서 자란애가	How could a guy
남한 초등학교	from the North go to / a South reunion?
그림자?	Shadow?
경남아!	Kyung-nam!
지원이랑 같이 있는	l'll send photos / of his associates
차 번호 보낼테니까	and plate numbers / so cross reference.
빨리 가가가가	Keep driving!
앞으로가요 빨리	Go, go!
지원이 지금 술집에	l got a report that / he passed out at a bar.
감시 붙여놨어요	l put a tail on him.
웬만해서	He doesn't normally drink.
뭔일이	Something's up.
교수, 피디, 목사	Professor, producer, pastor
피디란 새끼가빨갱이니까	A commie producer,
온천지가 빨갱이들이지	no wonder this country's / going to shit.
네... 여보세요 저기	Hello, l have some / special scoop,
민규철 피디님	could l talk to / producer Min Kyu-chul?
민피디님 중국취재 가셨는데	He went to China / on an assignment for a month.
중국 취재, 중국...	Ah, on an assignment.
- 예, 알겠습니다	- l see. / - What's the scoop?
특종? 니 똥구멍에	l shoved it up your asshole.
교수랑 피디는	Professor and the producer / left yesterday
국내엔 목사밖에 없어요	and only the pastor's / still in the country.
그 얘기를 왜 지금 해	Why didn't you tell me earlier!
이것들 벌써	Have they realized / What we're up to?
목사	A pastor.
성광교회! 딱 걸렸어	l got you red bastards.
- 야 화곡동 밟아	- Head for Hwagok. / - Yes, sir.
이기훈 목사님?	Pastor Lee?
어서들 오세요	Please come in.
아 예	Thank you.
너희들은 다 끝났어!	You're all finished, / rat fuckers!
왜들 이러십니까?	Who are you? / Why are you doing this?
우리 송지원이 친구야	We're Song Ji-won's friends.
난 동거남이고	l live with him.
동거남이요?	Live together?
송지원이 몰라?	Don't know Song Ji-won?
박기준	How about Park Ki-joon.
아 인준이!	Ah, ln-joon!
혹시 조인준이	Are you referring / to Jo ln-joon?
조인준이는	ln-joon is our client.
어이구 팔	Ow, my arm...
인준이는 말이에요	ln-joon
북에 가족이 있어요	has family / in the North.
아내랑 딸이 하나 있는데	Wife and a daughter,
못 본지가	but he hasn't seen them / in 7 years, l'm told.
인준이는 당국에서	ln-joon was betrayed and
버려진 신세에요	abandoned by / his own country.
그러니 자수를 하려고 그래도	He can't surrender / because of family
함부로 행동할 수가	back home even / if he wanted to.
기다리다 못했는지	He couldn't wait / any longer so
처자식을 데리고 나올라고	he wanted to bring / his family,
마음먹고	so he came to us.
근데...	But
생각보다	it was more costly / than he thought,
한참을 안보이다가...	and l didn't hear / from him for a while.
올 여름쯤인가	This past summer
돈을 구할 수 있을 것	he came back, saying
찾아왔습디다	he can get the money.
아파트 중도금!	Apartment payment.
그래서요...?	Then?
헌데, 거의 성사직전에	But before / we could get them out,
갑자기 핵문제가	the nuclear incident happened.
그러니 국경경계는	So naturally the border / tightened up
어제 우리 민PD랑	Producer Min and Prof. Hwang / took off yesterday.
아마 이번이 마지막이	l guess this might be / the last chance.
이제 지원이	Are you going to / report Ji-won now?
좀 기다려봐 임마...	Wait a couple of day.
식구들 데리고	He's bringing / his family back.
그럼 뭐	Won't he surrender then?
어때? 예쁘죠?	Pretty, huh?
나 베트남에 가서	l went to Vietnam
한 시간에 맞선을	and met 120 girls / in an hour
그중에서 제일 예뻤어	and she was the most / beautiful one.
자고로 남자가 결혼을	lf a man's / going to remarry,
꼭 미인하고	he must choose / the beautiful one.
젊은 친구는	Are you married?
아니요	No.
요즘 젊은이들은	Young people
결혼 안하고 혼자 사는 게	these days think it's better
- 좋은 줄 아는데...	- to live alone but... / - What's your wife's name?
용웬띠 뚜이안	Eunwenddi Ddooi An / Or Won Soo-young in Korean.
예쁘긴 한데	Beautiful but too smart.
몇 대 맞았다고	Making a fuss over / some beatings.
- 저쪽으로 가시면 돼요	- You could just go there. / - Thank you.
여자 데려다 주면	He'll beat her / if she comes back, right?
어이! 남에 집안 일	Hey, mind you / own business.
자기 집 일이나 신경 써!	His family is not / your concern.
어차피 자본주의는	Capitalism is about / finding happiness
내 행복을 찾는 거야	by taking another's wealth.
그게 죄가 아니야	That's not a crime, okay?
사장님은	Do you find happiness in
찾으러 다니는게	looking for / other men's women?
말조심해!	Watch your mouth!
네가 나에 대해서	You don't know / anything about me.
그건 마찬가지 아닙니까?	lsn't that the same?
하기 싫으면 하지 마!	Quit if you don't like it. / Bitch and moan.
뚜이안? 뚜이안씨?	Ddooi An? Miss Ddooi An?
장 사장님	Mr. Jung asked us / to find you.
같이 가주셔야겠습니다	Please come with us.
나 베트남 사람 아니에요	l'm not a Vietnamese, / l'm half Korean!
다 알고 왔어요	We already know.
너희들 다	Aren't you all illegal?
출입국 관리소에	Should l get the / immigration down here?
비켜	Move!
빨리 비켜	Out of the way!
나 한국 사람이라니까요!	- l said l'm a Korean! / - Do something!
♪ 동해물과 백두산이	l love this country!
야! 타잉훙 불러! 타잉훙!	Tihong! Call Tihong!
뚜이안씨 한국 사람 맞아요	Sure, you're a Korean, / l have no doubt.
한국 사람 맞대니까	l'm sure about that.
그만 좀 하십시오!	Please stop!
사장님은 사람들이	Do you see them / only as money?
이 자식이...	Son of a bitch!
인간적인 척 하지 마!	Don't pretend to be humane.
너도 돈 필요하잖아!	You need the money too!
아파트 중도금!	Remember the apartment?
이러니까 처자식한테도	No wonder your family left you.
뭐? 뭐라고 그랬어, 어?	What? / What did you just say?
한번 해보자는 거야?	You really want to / start this?
이 새끼가!	You bastard!
축구 안 봤는데	l didn't see the match.
이런 일은 십년에 한 번	Once in 10 years or so, huh?
그때 제대로	lt's because we didn't / settle last time.
어떡하실 거예요?	What do you think?
넌?	You?
할 수 있겠어요?	Can you manage?
하... 씨	Damn it.
가... 임마	Go, you bastard!
가라구 이 새끼야!	l said go!
괜찮아요?	Are you okay?
안 괜찮아!	l'm not okay.
와, 차 막히는 것 좀 봐	Look at that traffic.
사고 났나?	An accident?
아 추석이지	Ah, it's Thanksgiving.
야 추석이라	Everyone's heading home.
우린 이게 뭐냐	But look at us. / Bruised and battered.
에이고	You're lucky to be spending
추석은 가족과 함께!	Thanksgiving with family.
남편이 많이 때렸어요?	Did your husband / beat you a lot?
결혼해서 2년이면	l can have / Korean citizenship
한국 국적이 나오는데...	2 years after wedding.
우리 남편은	But he won't / sponsor me for it.
주민동록증	Saying l'd leave him / when l get it.
내가 동의 해달라고	Whenever l ask him / about it
때렸어요	he hits me.
부탁이 있는데요	l have a favor.
서울 가는 길에...	Could l see my sister on the way?
우리 동생 한 번만	Could l see my sister on the way?
동생도 여기와서	She also married here.
못 본지	l haven't seen her / in over 5 years.
부탁입니다	l beg of you.
기준아!	Ki-joon!
예	Yeah?
그냥 가자	Let's just go.
돈 못 버셔서	Too bad about the payment.
까짓거 현상금	Eh, it's only / a couple of bucks.
근데, 아까 베트남	Why did you let that boss go?
현상금 다 받으면	When we get the reward, / you're gonna leave.
아파트 중도금 다 갚으면	l'd hate to let you go once / you have your apartment.
장기적으로 네가 포상금의	You'll make me / more money over time.
안 그러냐?	You'll make me / more money over time.
건배	Cheers!
온 나라가	While Thanksgiving took / all over the country,
국제 사회는 곧 있을 북한...	North Korea has...
추석이 뭐 별거냐	Thanksgiving is no big deal.
UN 인전보장 이 사회는	UN Security Council announced that / they will enforce sanctions
대북 제재 조치를	when North Korea proceeds / the nuclear tests.
이에 정부는 오늘...	Therefore, the Government / convenes a meeting
대북 전문가들을 불러	to seek a solution with advisors.
특히 대북경제정책 연구원	Especially Prof. Ji, / Unification Policy Researcher would
북한 내	advise on expected venues / for the nuclear test.
자문을 구한 것으로	advise on expected venues / for the nuclear test.
야, 기준아, 우리 일한지	How long have / we worked together?
한 네달 넘었죠	About 4 months.
와 벌써 그렇게 됐나?	That long already?
추석인데, 가족들	Don't you miss / your family?
이혼했잖아!	l'm divorced!
생각하면 뭐해...	What's the point / in missing them?
가족도 같이 있을 때	Family is family / when we're together.
야 기준아!	Ki-joon,
형이라고	could you call me brother?
됐어요	Forget it, / why are you my brother?
함 불러봐 임마	Come on, just once. / Let's just pretend.
싫어요	No.
아 자식	Cocky prick.
니가 싫으면	Fine, l don't like you either
음, 일어났냐?	You up?
뭐하세요?	What are you doing?
다행히 마트가	Fortunately / the store was open.
늦었지만	lt's late but you should / put on a service
부모님한테	for your parents.
왜? 지방 쓸 줄 몰라?	Why? Don't know / how to do it?
어머니 성씨가	What's your mother's / maiden name?
안동 김씨입니다	Kim, An-dong district.
안동김씨?	An-dong Kim?
나도 이거	l'll give it a try.
요즘은 이북에서도	l hear the North have / services nowadays.
앉아라...	Sit...
제사 지내는데	Would l report you / during a service?
내가 누군지	Did you know who l am?
내가 누군지	Did you know all along?!
빨리 말해	Answer me!
그만하자 기준아...	Stop this, Ki-joon.
아니, 지원이지	No, you're Ji-won, / Song Ji-won.
왜 날 데리고 있었어?	Why did you keep me around?
왜 신고 안 했어?	Why didn't you report me?
너 하나 잡아서	You're a small fish.
잡으려면 간첩단	A spy ring would be / a different story.
헌데 니가 낙동강 오리알	l found out that / you were abandoned
얼마 전에 알게 됐어	by your organization.
그래서 나라도	So, now you want to sell me off.
나 같은 놈은	How much will they pay you?
칼치워 임마...	Lower the knife.
이젠, 나도 모르겠다...	Who knows what'll happen.
모든게 잘 풀리면은	lf everything goes well,
이 일이나 제대로	we could just / continue our business.
너나 나나 그 좋은	What will we do with our skills?
우리 둘이 뭉치면	We could make it big / if we cooperate.
그럼 가격 존나게	Then we hike up / the fees and
돈도 벌고 부자되고	make some serious dough.
좋은 일도 하고 그러자	And we'll help people too.
하던 절 마저 해...	Go on,
나도 너희 부모님께	l'll give your parents a bow too.
해	Go on.
여보세요?	Hello? Oh, Kyung-nam.
뭐? 손태...?	What? Son-tae?
어디야 거기?	Where are you?
어... 어...	Yeah... yeah, okay.
나 좀 나갔다 올게	l have to go out.
친구가 사고를	Something happened / to a friend.
솜씨가 아무래도	Looks like the job of Shadow. / lt must be him.
다시 내려왔나?	ls he back?
나 살고 싶다	l want to live.
나 살고 싶다	l want to live!
여기 송지원이다!	lt's Song Ji-won!
지원아	Ji-won, do you remember me?
우리 김성학	We met briefly 6 years ago.
나 이 분한테 네 이야기	Lee told me all about you.
그리고 네 사정 다 알아	l know about your situation.
그림자가 다시 나타났다	Shadow is active again.
그림자 있는데만 말해줘	We just want to find him.
니 비밀 철저히 보장한다	We can protect your secrecy.
당신 눈엔...	Do you see me...
내가 그런 시시한	as a spineless traitor?
잡어!	Catch him!
저 새끼 잡아	Catch him!
놓치면 안돼!	Don't let him get away!
지원 따라 붙어	Catch up to him!
경남아! 지원이 놔줘라!	Kyung-nam, let him go!
무슨 말씀이세요?	Sir, what are you saying?!
너도 알잖아!	You know
쟤 그림자한테	Shadow has abandoned him.
이 일과는 아무 상관없어!	He has nothing to do with this.
아니, 무슨...	But he may still / be a link to Shadow.
야... 하루 이틀만	Please, give him 2 days.
처자식이 탈출하면	When his family comes over, / he'll surrender.
아니, 그런 거 다 봐주고	How could we catch spies / with mercy and compassion?
팀장님 이렇게	You're putting me / in an awkward position.
어이 이한규!	Hey, Lee Han-kyu!
차 세워요! 아저씨	Please stop the car.
긴말 필요 없고	Hand over the GPS,
GPS 반납하고	and tell me about Ji-won.
돈은 충분히	We'll pay you handsomely.
거 헛다리 짚는건	Still same as always.
걔는 잡아서 뭐하시게?	What are you going / to do with him?
지원이 그림자한테	He's blacklisted by Shadow.
걔가 그림자 만나겠어요?	Would he still contact him?
그렇게 정보력이 없으시나	So incompetent...
GPS 달라는 건	l'm asking for the GPS so that / you don't get involved in this.
어쭙잖게 끼지 말란 뜻이야	l'm asking for the GPS so that / you don't get involved in this.
말 안 들으면	l could have you thrown in jail / if you don't comply.
너 하나 감방에	l could have you thrown in jail / if you don't comply.
참, 아니 때가	Times have changed,
안기부랍시고 민간인한테	you can't just threaten / a civilian. Money?
나 원 쌍팔년도	you can't just threaten / a civilian. Money?
한 십억 줄 건가?	Perhaps a million?
남이 다해논 거 거저	Stop crediting yourself / for others' work.
- 옛날이나 지금이나 뭐 달라진 게	- Nothing's changed around here! / - Hey! Hey!
어디가 임마!	Get back in here!
두번의 실수는 없다	There's no room / for mistake.
필요하다면	Shoot to kill if you have to.
지원아 전화 좀 받아...	Ji-won, pick up the phone!
아니 아니...	There's a GPS tracker / in your watch.
지금 니 시계에	There's a GPS tracker / in your watch.
너 지금 어디 있는지	They know where you are.
그러니까 제발	So throw out your watch.
지금 위치 어디야?	What's his position?
고속버스 터미널입니다	He's at the bus terminal.
핸드폰 발신중입니다	He's on his cell phone.
민피디님	Producer Min, it's ln-joon.
네 인준씨	Yes, ln-joon.
아무래도 마지막이 될 것	l called you because this / may be the last time.
그게 무슨 소리에요?	what are you saying?
저 때문에 가족들까지	l may have caused harm / to my family.
제가 없더라도	So please continue / the work even without me.
이만 끊겠습니다	l'm hanging up now.
노출됐습니다	We're exposed.
노출된 요원들 빼내고	Take out the exposed / agents and
그림자 접선할 때까지	track him until he makes / contact with Shadow.
현재 위치 종로, 종로	Current position, Jongro.
종로? 거기 누가 있지?	Jongro? Who's there?
조국이 너에게 마지막	Our country is giving you / a last chance.
널 증명하라오!	Prove yourself.
벌써부터 피 비린내가	l can already feel / the bloodbath.
빨리 근처	Contact the local / district authorities!
무슨 일입니까?	What's going on?
우리도 몰라요	l don't know, / we just received an order.
뭐 별일이야 있겠습니까?	lt's probably nothing.
총을 가지고 있어! 막아!	He has a gun! Block him!
그쪽이다	Coming to you,
반경 40미터 안에 있다	He's within 40m.
- 흩어져서 찾아!	- Spread out! / - Yes, sir.
뭐하네?	What are you waiting for? / Finish the job.
지원아! 송지원!	Ji-won! Song Ji-won!
어떻게 된거야 어?	What happened? / What about Shadow?
아무튼, 다행이다	Anyway, l'm glad you're okay.
다른 얘기 할 시간 없고	There's no time,
우선 시계부터 풀러!	give me your watch.
이 안에 GPS가 있어!	GPS tracker is in here.
왜 전화를 안 받어	Why didn't you answer / the phone?
이미 위치가 노출	NlS knows your position,
국정원에서	they'll swarm the area soon.
널 죽일지도 모르니깐	They might kill you, / so get out of here.
지교수 괜찮으세요?	Professor, are you all right? / Get out of here.
너 왜 그래? 어?	What's wrong?
당의 지시로 온거냐?	Did the party send you?
누구의 지시로 온거냐?	Who sent you?
그게 무슨 말입니까?	What is he saying?
변절자 새끼!	Fucking traitor. / Talks too goddamn much.
당의 지시로 온 게	lt wasn't / an order from above?
뭐이네?	What? / Mind your own business.
그럼 태순이도 그냥	Did you kill Tae-soon / on your own?
변절자를 처단 하는 건	Killing traitors
조국을 위한 일이야!	is a privileged job / for our nation.
너도 마찬가지야	You're one of them now.
저는 변절자가 아닙니다	l'm not a traitor.
너 북에 있는	Didn't you try / to defect your family?
제 가족은	What happened to my family?
어떻게 됐을 것 같나?	What do you think?
제 가족은	What happened to them?!
송지원이...미련하긴...!	Ji-won, you dumb idiot.
너 때문에 부하 잃고	l lost my colleagues, job
씨발	and my family because of you.
총 내려놓지 않으면	lf you don't drop / the gun, he'll die.
죽이십시오	Go ahead.
죽이십시오	Kill me!
지원이 그만해	Stop it, Ji-won.
아 새끼!	Bastard!
이쪽이다	Over here!
- 본부에 연락해	- Call the HQ! / - Okay.
- 진우 내려가봐	- Jin-woo, go down. / - Okay.
같이 가자우!	We go down together.
지원아!	Ji-won!
안됩니다	No, Shadow is still alive!
- 지원이는?	- What about Ji-won? / - We couldn't verify.
- 살았다!	- He's still alive! / - Ji-won!
야 씨 살았잖아	Still alive!
감상적인 새끼들...	Romantic bastards...
죽었습니다	He's dead.
지원 요청 취소하고	Cancel backup / and call paramedics.
괜찮냐?	Are you okay?
지원아! 정신 차려	Ji-won, wake up!
저는...	l...
누구도 배신하지 않았습니다	didn't... betray anyone...
알아 임마!	l know.
정신 차려	Wake up!
지원아	Ji-won!
빨리 빨리	Hurry up!
혹시 잘리면 전화해요	Call me when you're cut off.
형님!	Brother!
난 이제 몸도	l've recovered well
그럭 저럭	and doing all right.
조금 있으면	lsn't it Yoon-ji's / birthday soon?
이번에 일굴이라도	Go see her for a change.
또 혼자 집에서	Don't just stay home / and wonder.
형, 난 아마도	Perhaps it's time for me / to leave for somewhere familiar.
혼란스럽고 시끄러운	Perhaps it's time for me / to leave for somewhere familiar.
그래도 여기보단	l don't think / l belong here either.
여기서 집 사고	lt seems too hard
효선이 키우기	to buy a house and / raise Hyo-sun here.
우린 인연이 되면	lf there's any chance,
또 만나도록 합시다	we shall meet again.
하여튼 나 없는 동안	Anyway, take care / of things while l'm away.
네 사장님	Yes boss, have a good flight!
예, 인터내셔널	This is lnternational Task Force.
아, 저기요...	Miss...
네, 손님	Yes, sir.
여기 비즈니스에서는	ls it open bar / in business class?
네 손님	That's right
지금 필요하시다면	l could bring you / one if you like.
어, 그러면은 이 안에서	Then can you get me / the most expensive
온더 락스로 가득	whiskey on the rocks?
네, 알겠습니다	l'll prepare it right away.
누가 출발하기 전부터	Only village idiot / drinks whiskey
와인도 좋은 거 많구만	before the take off.
하여튼 뭘 해봤어야 알지	How could someone
매일 햄버거만 먹던 사람이	who only eats burgers know
이게 똥인지	the difference between / good and shit?
그렇지?	Right?
